player
-1 -1 8    -1 1 8    0 1 8      ;
1 1 1    1 1 1    1 1 1         ;
0 0 4
0 0 4    0 0 -1    0 1 0    -5 5 -5 5 2 10
triangle
-5 -5 1   5 -5 1    0 5 1
0.0 1.0 1.0    0.0 1.0 0.0    0.0 0.0 1.0
square
-5 -5 0    5 -5 0    5 5 0    -5 5 0
0.0 1.0 1.0    0.0 1.0 0.0    0.0 0.0 1.0    1.0 0.0 0.0