texturemap
res/textures/tmap.jpg
32 32
player
0 -750 30    0 0 0    0 0 0    0
0 1 0    0 0 1    -2 2 -2 2 4 10000
       |model: vertices
0 0
cuboid
0 0 -50    0 0 0    0 0 0    0    1000 1000 100    1 1
cuboid
-63 0 150    0 0 0    0 6.3 0    10    5 5 5    0 1
cuboid
0 0 150    0 0 0    4 2 1    75    25 25 25    0 0
cuboid
-125 0 150    0 0 0    3 0 0    75    25 25 25    0 0
cuboid
-125 0 200    0 0 0    3 5 0    75    25 25 25    1 0
cuboid
100 0 150    0 0 0    3 3 0    75    25 25 25    1 0
cuboid
200 0 150    0 0 0    3 3 3    50    15 15 15    1 0
cuboid
200 0 200    0 0 0    1 3 4    50    15 15 15    1 1
cuboid
200 0 250    0 0 0    0 0 0    50    15 15 15    0 1
end

|player: position    velocity    rotation   mass
| camera: direction    up    l r b t n f
| model: vertices
| texture: x y    coords

|cuboid: position    velocity    rotation   mass    width height length    texture: x y